%%%%%%%%%%%%%%%%%
%.   .         .%
% .    .        %
% % %%%%%   G  .%
% P     %.      %
%.      %       %
%       %.     .%
%%%%%%%%%%%%%%%%%
