%%%%%%
%.P. %
% %.%%  
%G   % 
%%%%%%
